NO ./sprites/north.xpm
EA ./sprites/east.xpm
SO ./sprites/south.xpm
WE ./sprites/west.xpm

C 225,30,0				
F 1,1,1     

1111111111
100000000011
10000000001
10000E0011
10000000001
100001000011
1111111111
