NO ./sprites/north.xpm
EA ./sprites/east.xpm
SO ./sprites/south.xpm
WE ./sprites/west.xpm

F 1,1,1     

C 225,30,0

        1111111111111111111111111
		1 10000000110000000001111
         111000001110001110001
        1001000000000001 10001
		1111111111111111111111111
							1111111111	
111111111011000001110000001110001
100000000011000001110000000000001   
100000000011000E01110111111111111
11110111111111011100000010001  
11110111111111011101010010001    
11000000110101011100000010001    
10000000000000001100000010001    
10000000000000001101010010001    
11000001110101011111011110N0111  
11110111 1110101 101111010001    
11111111 1111111 111111111111
