NO ./sprites/north.xpm
EA ./sprites/east.xpm
SO ./sprites/south.xpm
WE ./sprites/west.xpm

C 225,30,0				
F 1,1,1     


1111111111111111111111111111111111111
1000000000000000000000000000000000001
1000000000000000001000000000000000001
1000000000000000000000000000000000001
1000000000000000001000000000000000001
1000000000000000000000000000000000001
1000000000000000001000000000000000001
1000000000000000000000000000000000001
1000000000000000001000000000000000001
1000000000000000000000000000000000001
1000000000000000001000000000000000001
1000000000000000000000000000000000001
101010101010101010N010101010101010101
1000000000000000000000000000000000001
1000000000000000001000000000000000001
1000000000000000000000000000000000001
1000000000000000001000000000000000001
1000000000000000000000000000000000001
1000000000000000001000000000000000001
1000000000000000000000000000000000001
1000000000000000001000000000000000001
1000000000000000000000000000000000001
1000000000000000001000000000000000001
1000000000000000000000000000000000001
1111111111111111111111111111111111111
