NO ./sprites/north.xpm
EA ./sprites/east.xpm
SO ./sprites/south.xpm
WE ./sprites/west.xpm

C 225,30,0				
F 1,1,1     


1111111
1001001
1000001
110N011
1000001
1001001
1111111
