NO ./sprites/north.xpm
EA ./sprites/east.xpm
SO ./sprites/south.xpm
WE ./sprites/west.xpm

C 225,30,0				
F 1,1,1     


1111111111
10000000001
10000000001
10000000001
10000000001
10000000001
1111111111
10000100001
10000000001
10000N00001
10000000001
10000000001
1111111111
